11111111111111111111111111111111111111111111111111111111111111111111111111111
1P000000100000000000000000000000000000000000000000000000000000000000000000001
10111110100000000000000000000000000000000000000000000000000000000000000000001
101C1000100000000000000000000000000000000000000000000000000000000000000000001
10101010100000000000000000000000000000000000000000000000000000000000000000001
10101010000000000000000000000000000000000000000000000000000000000000000000001
10001C11100000000000000000000000000000000000000000000000000000000000000000001
10101110000000000000000000000000000000000000000000000000000000000000000000001
10100000000000000000000000000000000000000000000000000000000000000000000000001
10101000000000000000000000000000000000000000000000000000000000000000000000001
10101111111111111000000000000000000000000000000000000000000000000000000000011
101C10000000000010000000000000000000000000000000000000000000000000000000000E1
10111011111111101000000000000000000000000000000000000000000000000000000000011
1000000000000C101000000000000000000000000000000000000000000000000000000000001
11101011111111101000000000000000000000000000000000000000000000000000000000001
1C101000000000101000000000000000000000000000000000000000000000000000000000001
10101111111110100000000000000000000000000000000000000000000000000000000000001
10100000000010101000000000000000000000000000000000000000000000000000000000001
10101111111010101000000000000000000000000000000000000000000000000000000000001
100000001C1000100000000000000000000000000000000000000000000000000000000000001
10111110101010111000000000000000000000000000000000000000000000000000000000001
101C00100010101C1000000000000000000000000000000000000000000000000000000000001
10111010101010101000000000000000000000000000000000000000000000000000000000001
100000001C1C100010000000000000000000000000000000000000000000C0000000000000001
11111111111111111111111111111111111111111111111111111111111111111111111111111