111111
100001
10PC01
100E01
111111